{
  "p": { "x": 400, "y": 255 },
  "r": 30,
  "s": [],
  "b": [
    { "x": 272, "y": 220 },
    { "x": 304, "y": 220 },
    { "x": 336, "y": 220 },
    { "x": 368, "y": 220 },
    { "x": 400, "y": 220 },
    { "x": 432, "y": 220 },
    { "x": 464, "y": 220 },
    { "x": 496, "y": 220 },
    { "x": 464, "y": 300 },
    { "x": 304, "y": 300 }
  ],
  "g": [{ "x": 368, "y": 700 }],
  "h": [
    { "x": 550, "y": 290 },
    { "x": 200, "y": 290 }
  ]
}
