{
  "p": { "x": 400, "y": 255 },
  "r": 30,
  "s": [],
  "b": [
    { "x": 272, "y": 220 },
    { "x": 303, "y": 220 },
    { "x": 334, "y": 220 },
    { "x": 365, "y": 220 },
    { "x": 396, "y": 220 },
    { "x": 427, "y": 220 },
    { "x": 458, "y": 220 },
    { "x": 489, "y": 220 },
    { "x": 456, "y": 300 },
    { "x": 304, "y": 300 }
  ],
  "g": [{ "x": 368, "y": 700 }],
  "h": [
    { "x": 550, "y": 290 },
    { "x": 200, "y": 290 }
  ]
}
